00 00 00 00 00 00 00 00 00 00 00 00
00 08 08 08 00 00 00 00 08 08 08 00
00 08 00 00 00 00 00 00 00 00 08 00
00 08 00 08 08 08 08 08 08 00 08 00
00 08 00 00 00 00 00 00 00 00 08 00
00 08 08 08 00 00 00 00 08 08 08 00
00 00 00 00 00 00 00 00 00 00 00 00