00 00 00 11 11 11 11 11 11 00 00 00
00 03 00 00 11 11 11 11 00 00 04 00
00 00 00 00 00 11 11 00 00 00 00 00
00 03 00 00 03 00 00 04 00 00 04 00
00 00 00 00 00 00 00 00 00 00 00 00
00 03 00 00 03 00 00 04 00 00 04 00
00 00 00 00 00 00 00 00 00 00 00 00